R 800 600
NO ../texture_pack/wall_text_9_512.bmp
SO ../texture_pack/wall_text_5_512.bmp
EA ../texture_pack/wall_text_10_512.bmp
WE ../texture_pack/wall_text_6_512.bmp
S ../texture_pack/terminal_frame_1024x512_2.bmp
F 15,17,19
C 23,29,32

        1111111111111111111111111
        1000000000110000000000001
        1011000001110000002000001
        1001E02000000000000000001
111111111011000001110000000000001
100000000011000001110111111111111
11110111111111011100000010001
11110111111111011101010010201
11000000110101011100000000001
10002000000000001100000010001
10000000000000001101010010001
1100000111010101111101111000111
11110111 1110101 101111010001
11111111 1111111 111111111111
