R 1024 768
NO ./texture_pack/wall_text_9_512.bmp
SO ./texture_pack/wall_text_6_512.bmp
EA ./texture_pack/wall_text_10_512.bmp
WE ./texture_pack/wall_text_5_512.bmp
S ./texture_pack/terminal_frame_1024x512_2.bmp
F 15,17,19
C 23,29,32

         111111111111111
         100000110000001
         100000000020001
         100000110000001
         111111111100111  1111111111
                10000001  1000000001
                10000001111002000001
             11111100000000000010101
             10000000001111000001001
             11111001111  10N0010101
                10000001  1111000001
                10200111     1000001
                10000011     1111111
                11111111 
