R 1024 768
NO ./texture_pack/wall_text_9_512.bmp
SO ./texture_pack/wall_text_10_512.bmp
EA ./texture_pack/wall_text_5_512.bmp
WE ./texture_pack/wall_text_6_512.bmp
S ./texture_pack/terminal_frame_1024x512_2.bmp
C 15,17,20
F 23,29,32

 111111111
 100000001  111111
 1000S0001  100001
 10000000111100201
 10000000000000001
 10002000111100001
 100000001  110011
 111111111   1001
             1001
           11100111
           10000001
           10000201
           10000001
           11111111
